NO textures/torch/torch1_wall_1.xpm
NO textures/torch/torch2_wall_1.xpm
NO textures/torch/torch3_wall_1.xpm
SO textures/torch/torch2_wall_2.xpm
SO textures/torch/torch3_wall_2.xpm
SO textures/torch/torch1_wall_2.xpm
WE textures/torch/torch3_wall_3.xpm
WE textures/torch/torch1_wall_3.xpm
WE textures/torch/torch2_wall_3.xpm
EA textures/torch/torch1_wall_4.xpm
EA textures/torch/torch2_wall_4.xpm
EA textures/torch/torch3_wall_4.xpm

F 150,75,0
C 41,117,119

         11111111111111111111111111111
         10000000001100000000000000001
         10110000011100000001111111111
11111111110000000000000000011111
        1011000001110000000000001
11111111100110000011101111111111
11110111111111011100000010001
11110111111111011101010010001
11000000110101011100000010010
10000000000000001100000010001
10000000000000001100010000001
11000000110101000000000100001
11110111110101000000001010001
10000000001100000100001110001
10000000000000000000000001001
10000000111100010000N00001001
100000001  100110101110000001
10000000111110000001 10100001
11111111111111111111 11111111
