NO textures/wall_1.xpm
SO textures/wall_2.xpm
WE textures/wall_3.xpm
EA textures/wall_4.xpm

F 184,113,39
C 51,198,227

11111111111111111
10000000000000001
10000000000000001
10000000100000001
10000000000000001
100000000000000W1
11111111111111111
