NO textures/wall_1.xpm
SO textures/wall_1.xpm
WE textures/wall_1.xpm
EA textures/wall_1.xpm

F 184,113,39
C 51,198,266

11111111111111111111111111111
10000000001100000000000000001
10110000011100000001111011111
11111111110000000000000000010111
		10110000011100000000000111111
		1000000000110000011101100111
11111111111111011100000010001
11110111111111011101010010001
11000000110101011100000010001
10000000000000001100000010001
10000000000000001100010000001
11000000110101000000000000001
11110111110101000000000000001
10000000001100000100000010001
10000000000000000000000001001
10000000111100010000N00001001
100000001  100110101110000001
10000000111110000001 10100001
11111111111111111111 11111111
