NO textures/wall_1.xpm
SO textures/wall_2.xpm
WE textures/wall_3.xpm
EA textures/wall_4.xpm


F 51,255,153
C 0,254,255

11111111111111111111
1000000000000000111
100000000000000011111
1000000010000000111111111
100000000000000011111
100000000000001W111
11111111111111111
