NO textures/wall_1.xpm
SO textures/wall_1.xpm
WE textures/wall_1.xpm
EA textures/wall_1.xpm

F 184,113,39
C 51,198,227


1111
10N1
1111
